Contact Group Name:	Dansgroep Heliopsis vzw - Street 2/3 - Werkjaar 2024-2025

Members:	 

Ackaert Imani	imani.ackaert@gmail.com
Bocklandt Lucca	luccabocklandt@hotmail.com
Bogaert Sam (Samba1998@gmail.com)	Samba1998@gmail.com
Claeys Britt 2 (britt.claeys3@gmail.com)	britt.claeys3@gmail.com
Crombez Eline	vermeirsch.m@gmail.com
De Block Jade		evy_verstrynge@hotmail.com
Deconinck Louise	tine.kreps@telenet.be
Delcroix Emily	phdelcroix@yahoo.co.uk
Dobbelaere Naëlle	magaliboedt@hotmail.com
El Hadi Alyssa	sarrah17_dhraief@hotmail.com
Elshout Anais	w-elshout@hotmail.com
Geraci Julie	giuliageraci@hotmail.com
Hellebuyck Victoria	briand@degrootetrucks.com
Meersman Giulietta	sylvia.lagrou@stradalegale.be
Moeykens Aline	deknock@skynet.be
Moeykens Aline 2 	deknock01@icloud.com
Opsomer Louise	schiettecatte.nathalie@gmail.com
Peeters Jenna	kaat.lannoy@telenet.be
Poppe Erien (poppe-vanpaemel@telenet.be)	poppe-vanpaemel@telenet.be
Speecke Marit	timmermannancy@gmail.com
Torricelli Ella	ella8300@icloud.com
Vandamme Lucie	sophie@interiorsbysophie.be
Vandamme Lucie (info@knokke-interiors.be)	info@knokke-interiors.be
Vanherpe Ymke	ymkevanherpe@hotmail.com
Vantorre Joya (joyavantorre@gmail.com)	joyavantorre@gmail.com
Versporten Linde (lindeversporten@gmail.com)	lindeversporten@gmail.com
Vossen Lili	sylvie_cantraine@yahoo.com
Westyn Jessie (jessie-westyn@hotmail.com)	jessie-westyn@hotmail.com


