Contact Group Name:	Dansgroep Heliopsis vzw - Modern Kids - Werkjaar 2024-2025

Members:	 

Aarnouts Miet	miet_aarnouts@hotmail.com
Andries Nanou	lisa_verleye@hotmail.com
Buyck Louise 	nathaliegoorix@hotmail.com
Carton Enna	melissamommens@hotmail.com
Cattoor Lilly & Rose	Info@lillyandrose.be
De Jaeghere Olivia	samencharlotte@telenet.be
De Paep Lieke	sarahds1985@gmail.com
De Schuyter Laïs	kimmareydt@hotmail.com
Debrabandere Floor	instituutkelly@skynet.be
Demey Charlotte	mobouckingrid@hotmail.com
Dijkstra Doutzen	julie.brutein@gmail.com
Duckaert Inaya	buildingdiamonds1@gmail.com
Landuyt Anne-Fleur	sylviaverbouw@gmail.com
Lily Trenson	stefanieterryn@hotmail.com
Louise Van Den Heuvel	kristof@knokadvas.be
Mainil Cilou (lies-eeckeloo@hotmail.be)	lies-eeckeloo@hotmail.be
Oosterss Renée	anka_demulder@hotmail.com
Smits Axelle	kris.smits2@telenet.be
Teirlynck Maité (els2308@gmail.com)	els2308@gmail.com
Valentin Livia	belinda_incoul@hotmail.com
Valentin Livia 2	jeremyvalentin555@gmail.com
Vandemoere Estelle	evytje_moens@msn.com
Vanden Poel Lara	teodora.angelova22@gmail.com
Vanden Poel Lara 2 (mathias.vandenpoel@icloud.com)	mathias.vandenpoel@icloud.com
Vanherweghe Romy (deweerdtshirley@gmail.com)	deweerdtshirley@gmail.com
Verdruye Ella-Lise	delphine.jacobs1@gmail.com
Walravens Kato	sylvietilmans@hotmail.com
Watteeuw Aurélie (hanne.eeckeloo@hotmail.be)	hanne.eeckeloo@hotmail.be
Wittewrongel Ona (christy.de.graeve@icloud.com)	christy.de.graeve@icloud.com


