Contact Group Name:	Dansgroep Heliopsis vzw - Street 1 - Werkjaar 2024-2025

Members:	 

Barnes Lily	marjolijnrotsaert@hotmail.com
Beirens Blu	benbeirens@gmail.com
Crombez Eline	vermeirsch.m@gmail.com
De Block Romy	evy_verstrynge@hotmail.com
De Groote Eline	tamaralefevere@hotmail.com
Deconinck Louise	tine.kreps@telenet.be
Devisch Yliana	melissa_lamote@hotmail.com
Dobbelaere Naëlle	magaliboedt@hotmail.com
Eggerickx Juliette	vanderheydenkate@hotmail.com
Elshout Anaïs	w-elshout@hotmail.com
Geraci Julie	giuliageraci@hotmail.com
Hertsens Elise	sofiehertsens@hotmail.com
Heylen Olivia	joycedemey@telenet.be
Hongenaert Amélie (nathalie.beyen@skynet.be)	nathalie.beyen@skynet.be
Isbecque Noah	vicky.pauwaert@icloud.com
Kasule Alison	vstaal@hotmail.com
Martens Madeleine (annemie.schepens@howest.be)	annemie.schepens@howest.be
Moke Noor	kim@moke-declercq.be
Muyllaert Felipe	ann@thecommunicationgroup.be
Opsomer Louise	schiettecatte.nathalie@gmail.com
Peeters Jenna	kaat.lannoy@telenet.be
Pirson Yllona	meliblaimont@hotmail.com
Roelens Charlotte (roelenschristophe@msn.com)	roelenschristophe@msn.com
Tato Kiara (faire.tato@icloud.com)	faire.tato@icloud.com
Vandamme Lucie	sophie@interiorsbysophie.be
Vandekerkhove Maud	e.wintein@hotmail.com
Vicky Pauwaert	pierre_isbecque@msn.com


