Contact Group Name:	Dansgroep Heliopsis vzw - Volwassenen

Members:	 

Aarnouts Miet	miet_aarnouts@hotmail.com
Axters Mieke	mieke_axters@hotmail.com
Baes Marlies	marlies_baes@hotmail.com
Baetens Sarah	sarah.baetens1@gmail.com
Bogaert Elke	elke_bogaert@hotmail.com
Bogaert Jenneke	jenneke.bogaert@hotmail.be
Bulcke Tiffany	tiffany.bulcke@gmail.com
Copman Christel	christelcopman@live.com
De Cock Sara	sara.decock@hotmail.com
Desmidt Sara	sara_desmidt@skynet.be
Easton Cato	cato.easton1@hotmail.com
El Hadi Alyssa	sarrah17_dhraief@hotmail.com
Geraci Julie (giuliageraci@hotmail.com)	giuliageraci@hotmail.com
Ghesquiere Ellen	ellenghesquiere@outlook.be
Lamote Melissa	melissa_lamote@hotmail.com
Lierman Cindy	cindy.lierman@telenet.be
Muyllaert An	anmuyllaert@yahoo.com
Pauwaert Laura	pauwaertlaura@hotmail.com
Proot Chanel (chanel1dproot@gmail.com)	chanel1dproot@gmail.com
Rappé Kimsy (rappekimsy@gmail.com)	rappekimsy@gmail.com
Savels Elsie	Moens_Tamara@hotmail.com
Scalici Imani	imaniscalici07@gmail.com
Stichelbaut Lynn	stichelbaut.lynn@gmail.com
Van Hoorebeke Isabelle	isabelle.vanhoorebeke@skynet.be
Vanherpe Bieke	biekevanherpe@hotmail.com


