Contact Group Name:	Dansgroep Heliopsis vzw - Street Teens - Werkjaar 2024-2025

Members:	 

Baeckelandt Enora	wijnepatricia@gmail.com
Baert Amy	sarah_roelandt@hotmail.com
Brouckaert Emma en Liana (demeesterkim@hotmail.com)	demeesterkim@hotmail.com
Coppejans Dieuwke	johnnycoppejans@hotmail.com
De Coussemaker Emilia	kurt.cheryl@telenet.be
De Paep Louna	sarahds1985@gmail.com
De Schuyter Loena	saradeleener@telenet.be
Desmidt Chiara	melanievangheluwe@icloud.com
Desmidt Dante	fre_desmidt@hotmail.com
Devisch Yliana	melissa_lamote@hotmail.com
Dobbelaere Noëlie	magaliboedt@hotmail.com
Filisia Tamsin	kasiafilisia@gmail.com
Geraci Julie (giuliageraci@hotmail.com)	giuliageraci@hotmail.com
kreps Gigi (liesbethkreps@gmail.com)	liesbethkreps@gmail.com
Leemans Jorbe	kurzieboy@hotmail.com
Lierman Anaïs	rebecca_Maelfeyt@hotmail.com
Mareydt Marie-Lou	tommareydt@hotmail.com
Marley Leuntjens	anke.dekee@knokke-heist.be
Meyers Alexie	welvaertjanice@hotmail.com
Meyers Elise	shana.moyaert@hotmail.com
Ouders Vossen Elle	sylvie_cantraine@yahoo.com
Patteet Charlotte	cverstraaten@hotmail.com
Peeters Lee-Ann	kaat.lannoy@outlook.com
Sarah Deputter	sdeputter@icloud.com
Savels Elsie	Moens_Tamara@hotmail.com
Savels Lise	kellefleerackers@hotmail.com
Van Biervliet Gaëlle (caroline.goeminne@telenet.be)	caroline.goeminne@telenet.be
Vandierendonck Kate	devoogtannelies@gmail.com
Vansteenkiste Niene	sarahdobbelaere@icloud.com
Vansteenkiste Niene 2	dries.vansteenkiste@telenet.be
Verlinde Fleur	heikedeweerdt@gmail.com
Wasnaire Fay (lizzy.litaer@gmail.com)	lizzy.litaer@gmail.com


